12 12
----------  
|...H....|  
|........|  
|........|  
|........|  
|........+##
|........| #
|........| #
|........| #
----+----- #
    #      #
    ########