20 15
+------------------+
|..................|
|..................|
|..................|
|..................|
|.....+------+.....|
|.....|      |.....|
|.....|      |.....|
|.....|      |.....|
+.....+------+.....|
|..................|
|.........+--------+
|.........|        |
|.........+--------|
|..............=...|
+------.--+--------+


